0,0,0,0,0,0,0,
0,0,0,1,0,0,0,
0,0,0,1,1,0,0,
0,0,1,2,1,0,0,
0,0,1,1,1,0,0,
0,0,0,0,0,0,0,
0,0,0,0,0,0,0,
\0,0,0,0,0,0,0,
0,0,0,8,0,0,0,
0,0,0,3,12,0,0,
0,0,9,4,10,0,0,
0,0,3,5,6,0,0,
0,0,0,0,0,0,0,
0,0,0,0,0,0,0,
\0,0,0,0,0,0,0,
0,0,0,0,0,0,0,
0,0,0,0,0,0,0,
0,0,0,0,0,0,0,
0,0,0,0,0,0,0,
0,0,0,0,0,0,0,
0,0,0,0,0,0,0,
\