0,0,0,1,0,0,0,
0,0,0,1,0,0,0,
0,0,0,1,0,0,0,
1,1,1,1,1,1,1,
0,0,0,1,0,0,0,
0,0,0,1,0,0,0,
0,0,0,1,0,0,0,
\0,0,0,8,0,0,0,
0,0,0,10,0,0,0,
0,0,0,10,0,0,0,
1,5,5,15,5,5,4,
0,0,0,10,0,0,0,
0,0,0,10,0,0,0,
0,0,0,2,0,0,0,
\0,0,0,1,0,0,0,
0,0,0,2,0,0,0,
0,0,0,1,0,0,0,
1,2,1,0,1,2,1,
0,0,0,1,0,0,0,
0,0,0,2,0,0,0,
0,0,0,1,0,0,0,
\