0,0,0,0,0,0,0,
0,0,0,0,0,0,0,
0,0,0,1,0,0,0,
0,0,1,1,1,0,0,
0,0,0,1,0,0,0,
0,0,0,0,0,0,0,
0,0,0,0,0,0,0,
\0,0,0,0,0,0,0,
0,0,0,0,0,0,0,
0,0,0,0,0,0,0,
0,0,0,0,0,0,0,
0,0,0,0,0,0,0,
0,0,0,0,0,0,0,
0,0,0,0,0,0,0,
\0,0,0,0,0,0,0,
0,0,0,0,0,0,0,
0,0,0,0,0,0,0,
0,0,0,1,0,0,0,
0,0,0,2,0,0,0,
0,0,0,0,0,0,0,
0,0,0,0,0,0,0,
\4,3,5,3,1,0,
4,2,4,3,1,0,
4,3,4,4,1,0,
3,3,4,3,1,0,
\