0,0,0,2,0,0,0,
0,2,1,1,1,2,0,
0,1,0,2,0,1,0,
1,2,1,1,1,2,1,
0,1,0,2,0,1,0,
0,2,1,1,1,2,0,
0,0,0,2,0,0,0,
\0,0,0,8,0,0,0,
0,9,5,15,5,12,0,
0,10,0,10,0,10,0,
1,15,5,15,4,11,4,
0,10,0,10,0,10,0,
0,3,5,15,5,6,0,
0,0,0,2,0,0,0,
\0,0,0,0,0,0,0,
0,0,0,0,0,0,0,
0,0,0,0,0,0,0,
0,0,0,0,0,0,0,
0,0,0,0,0,0,0,
0,0,0,0,0,0,0,
0,0,0,0,0,0,0,
\