0,0,0,0,0,0,0,
1,0,0,0,0,0,0,
1,1,1,1,0,0,0,
1,3,1,1,0,0,0,
0,0,0,0,0,0,0,
0,0,0,0,0,0,0,
0,0,0,0,0,0,0,
\0,0,0,0,0,0,0,
8,0,0,0,0,0,0,
11,5,5,12,0,0,0,
3,5,5,6,0,0,0,
0,0,0,0,0,0,0,
0,0,0,0,0,0,0,
0,0,0,0,0,0,0,
\0,0,0,0,0,0,0,
0,0,0,0,0,0,0,
0,0,0,0,0,0,0,
0,0,0,0,0,0,0,
0,0,0,0,0,0,0,
0,0,0,0,0,0,0,
0,0,0,0,0,0,0,
\0,0,0,0,0,0,0,
2,0,0,0,0,0,0,
0,0,1,0,0,0,0,
0,0,0,0,0,0,0,
0,0,0,0,0,0,0,
0,0,0,0,0,0,0,
0,0,0,0,0,0,0,
\